TTTTTTTT
T      T
T R    T
T      T
T       .
T      T
T  P   T
T      T
TTTTTTTT